0000000000
0133313320
0321323130
0332332320
0213313230
0321333230
0333213330
0132332310
0332211320
0000000000